DOWN
##123##
#-b---#
#-----#
####--#
#-----#
#-----#
####e##

input:
---
-b-
21#

after rotation:
#12
-b-
---