LEFT
##123##
#-b---#
#-----#
####--#
#-----#
#-----#
####e##

input:
--#
-b1
--2

after rotation:
#12
-b-
---