###
#b-
#--

##123##
#b----#
#-----#
####--#
#-----#
#-----#
####e##

moves RIGHT 

##123##
#-b---#
#-----#
####--#
#-----#
#-----#
####e##

input:
2--
1b-
#--

after rotation:

#12
-b-
---

moves RIGHT 

##123##
#--b--#
#-----#
####--#
#-----#
#-----#
####e##


#--
#b-
#--

after rotation:

###
-b-
---